339,339,339,339,339,339,339,339,339,339,339,339,339,339,339,339,339,339,339,339,339,339,339,339,339,339,339,339,339,339,339,339,339,339,339,339,339,339,339,339,339,339,339,339,339,339,339,339,339,339,339,339,339,339,339,339,339,339,339,339,339,339,339,339,339,339,339,339,339,339,339,339,339
339,339,339,339,339,339,339,339,339,339,339,339,339,339,339,339,339,339,339,339,339,339,339,339,339,339,339,339,339,339,339,339,339,339,339,339,339,339,339,339,339,339,339,339,339,339,339,339,339,339,339,339,339,339,339,339,339,339,339,339,339,339,339,339,339,339,339,339,339,339,339,339,339
339,339,339,339,339,339,339,339,339,339,339,339,339,339,339,339,339,339,339,339,339,339,339,339,339,339,339,339,339,339,339,339,339,339,339,339,339,339,339,339,339,339,339,339,339,339,339,339,339,339,339,339,339,339,339,339,339,339,339,339,339,339,339,339,339,339,339,339,339,339,339,339,339
339,339,339,339,339,339,339,339,339,339,339,339,339,339,339,339,339,339,339,339,339,339,339,339,339,339,339,339,339,339,339,339,339,339,339,339,339,339,339,339,339,339,339,339,339,339,339,339,339,339,339,339,339,339,339,339,339,339,339,339,339,339,339,339,339,339,339,339,339,339,339,339,339
339,339,339,339,339,339,339,339,339,339,339,339,339,339,339,339,339,339,339,339,339,339,339,339,339,339,339,339,339,339,339,339,339,339,339,339,339,339,339,339,339,339,339,339,339,339,339,339,339,339,339,339,339,339,339,339,339,339,339,339,339,339,339,339,339,339,339,339,339,339,339,339,339
339,339,339,339,339,339,339,339,339,339,339,339,339,339,339,339,339,339,339,339,339,339,339,339,339,339,339,339,339,339,339,339,339,339,339,339,339,339,339,339,339,339,339,339,339,339,339,339,339,339,339,339,339,339,339,339,339,339,339,339,339,339,339,339,339,339,339,339,339,339,339,339,339
339,339,339,339,339,339,339,339,339,339,339,339,339,339,339,339,339,339,339,339,339,339,339,339,339,339,339,339,339,339,339,339,339,339,339,339,339,339,339,339,339,339,339,339,339,339,339,339,339,339,339,339,339,339,339,339,339,339,339,339,339,339,339,339,339,339,339,339,339,339,339,339,339
339,339,339,339,339,339,339,339,339,339,339,339,339,339,339,339,339,339,339,339,339,339,339,339,339,339,339,339,339,339,339,339,339,339,339,339,339,339,339,339,339,339,339,339,339,339,339,339,339,339,339,339,339,339,339,339,339,339,339,339,339,339,339,339,339,339,339,339,339,339,339,339,339
339,339,339,339,339,339,339,339,339,339,339,339,339,339,339,339,339,339,339,339,339,339,339,339,339,339,339,339,339,339,339,339,339,339,339,339,339,339,339,339,339,339,339,339,339,339,339,339,339,339,339,339,339,339,339,339,339,339,339,339,339,339,339,339,339,339,339,339,339,339,339,339,339
339,339,339,339,339,339,339,339,339,339,339,339,339,339,339,339,339,339,339,339,339,339,339,339,339,339,339,339,339,339,339,339,339,339,339,339,339,339,339,339,339,339,339,339,339,339,339,339,339,339,339,339,339,339,339,339,339,339,339,339,339,339,339,339,339,339,339,339,339,339,339,339,339
339,339,339,339,339,339,339,339,339,339,339,339,339,339,339,339,339,339,339,339,339,339,339,339,339,339,339,339,339,339,339,339,339,339,339,339,339,339,339,339,339,339,339,339,339,339,339,339,339,339,339,339,339,339,339,339,339,339,339,339,339,339,339,339,339,339,339,339,339,339,339,339,339
339,339,339,339,339,339,339,339,339,339,339,339,339,339,339,339,339,339,339,339,339,339,339,339,339,339,339,339,339,339,339,339,339,339,339,339,339,339,339,339,339,339,339,339,339,339,339,339,339,339,339,339,339,339,339,339,339,339,339,339,339,339,339,339,339,339,339,339,339,339,339,339,339
339,339,339,339,339,339,339,339,339,339,339,339,339,339,339,339,339,339,339,342,347,347,347,347,347,347,347,347,347,347,347,347,347,347,347,347,347,347,347,347,347,347,347,347,347,347,347,347,347,347,347,347,347,341,339,339,339,339,339,339,339,339,339,339,339,339,339,339,339,339,339,339,339
339,339,339,339,339,339,339,339,339,339,339,339,339,339,339,339,339,339,339,345,340,340,340,340,340,340,340,340,340,340,340,340,340,340,340,340,340,340,340,340,340,340,340,340,340,340,340,340,340,340,340,340,340,346,339,339,339,339,339,339,339,339,339,339,339,339,339,339,339,339,339,339,339
339,339,339,339,339,339,339,339,339,339,339,339,339,339,339,339,339,339,339,345,340,340,340,340,340,340,340,340,340,340,340,340,340,340,340,340,340,340,340,340,340,340,340,340,340,340,340,340,340,340,340,340,340,346,339,339,339,339,339,339,339,339,339,339,339,339,339,339,339,339,339,339,339
339,339,339,339,339,339,339,339,339,339,339,339,339,339,339,339,339,339,339,345,340,340,340,340,340,340,340,340,340,340,340,340,340,340,340,340,340,340,340,340,340,340,340,340,340,340,340,340,340,340,340,340,340,346,339,339,339,339,339,339,339,339,339,339,339,339,339,339,339,339,339,339,339
339,339,339,339,339,339,339,339,339,339,339,339,339,339,339,339,339,339,339,345,340,340,340,340,340,340,340,340,340,340,340,340,340,340,340,340,340,340,340,340,340,340,340,340,340,340,340,340,340,340,340,340,340,346,339,339,339,339,339,339,339,339,339,339,339,339,339,339,339,339,339,339,339
339,339,339,339,339,339,339,339,339,339,339,339,339,339,339,339,339,339,339,345,340,340,340,340,340,340,340,340,340,340,340,340,340,340,340,340,340,340,340,340,340,340,340,340,340,340,340,340,340,340,340,340,340,346,339,339,339,339,339,339,339,339,339,339,339,339,339,339,339,339,339,339,339
339,339,339,339,339,339,339,339,339,339,339,339,339,339,339,339,339,339,339,345,340,340,340,340,340,340,340,340,340,340,340,340,340,340,340,340,340,340,340,340,340,340,340,340,340,340,340,340,340,340,340,340,340,346,339,339,339,339,339,339,339,339,339,339,339,339,339,339,339,339,339,339,339
339,339,339,339,339,339,339,339,339,339,339,339,339,339,339,339,339,339,339,345,340,340,340,340,340,340,340,340,340,340,340,340,340,340,340,340,340,340,340,340,340,340,340,340,340,340,340,340,340,340,340,340,340,346,339,339,339,339,339,339,339,339,339,339,339,339,339,339,339,339,339,339,339
339,339,339,339,339,339,339,339,339,339,339,339,339,339,339,339,339,339,339,345,340,340,340,340,340,340,340,340,340,340,340,340,340,340,340,340,340,340,340,340,340,340,340,340,340,340,340,340,340,340,340,340,340,346,339,339,339,339,339,339,339,339,339,339,339,339,339,339,339,339,339,339,339
339,339,339,339,339,339,339,339,339,339,339,339,339,339,339,339,339,339,339,345,340,340,340,340,340,340,340,340,340,340,340,340,340,340,340,340,340,340,340,340,340,340,340,340,340,340,340,340,340,340,340,340,340,346,339,339,339,339,339,339,339,339,339,339,339,339,339,339,339,339,339,339,339
339,339,339,339,339,339,339,339,339,339,339,339,339,339,339,339,339,339,339,345,340,340,340,340,340,340,340,340,340,340,340,340,340,340,340,340,340,340,340,340,340,340,340,340,340,340,340,340,340,340,340,340,340,346,339,339,339,339,339,339,339,339,339,339,339,339,339,339,339,339,339,339,339
339,339,339,339,339,339,339,339,339,339,339,339,339,339,339,339,339,339,339,345,340,340,340,340,340,340,340,340,340,340,340,340,340,340,340,340,340,340,340,340,340,340,340,340,340,340,340,340,340,340,340,340,340,346,339,339,339,339,339,339,339,339,339,339,339,339,339,339,339,339,339,339,339
339,339,339,339,339,339,339,339,339,339,339,339,339,339,339,339,339,339,339,345,340,340,340,340,340,340,340,340,340,340,340,340,340,340,340,340,340,340,340,340,340,340,340,340,340,340,340,340,340,340,340,340,340,346,339,339,339,339,339,339,339,339,339,339,339,339,339,339,339,339,339,339,339
339,339,339,339,339,339,339,339,339,339,339,339,339,339,339,339,339,339,339,345,340,340,340,340,340,340,340,340,340,340,340,340,340,340,340,340,340,340,340,340,340,340,340,340,340,340,340,340,340,340,340,340,340,346,339,339,339,339,339,339,339,339,339,339,339,339,339,339,339,339,339,339,339
339,339,339,339,339,339,339,339,339,339,339,339,339,339,339,339,339,339,339,345,340,340,340,340,340,340,340,340,340,340,340,340,340,340,340,340,340,340,340,340,340,340,340,340,340,340,340,340,340,340,340,340,340,346,339,339,339,339,339,339,339,339,339,339,339,339,339,339,339,339,339,339,339
339,339,339,339,339,339,339,339,339,339,339,339,339,339,339,339,339,339,339,345,340,340,340,340,340,340,340,340,340,340,340,340,340,340,340,340,340,340,340,340,340,340,340,340,340,340,340,340,340,340,340,340,340,346,339,339,339,339,339,339,339,339,339,339,339,339,339,339,339,339,339,339,339
339,339,339,339,339,339,339,339,339,339,339,339,339,339,339,339,339,339,339,345,340,340,340,340,340,340,340,340,340,340,340,340,340,340,340,340,340,340,340,340,340,340,340,340,340,340,340,340,340,340,340,340,340,346,339,339,339,339,339,339,339,339,339,339,339,339,339,339,339,339,339,339,339
339,339,339,339,339,339,339,339,339,339,339,339,339,339,339,339,339,339,339,345,340,340,340,340,340,340,340,340,340,340,340,340,340,340,340,340,340,340,340,340,340,340,340,340,340,340,340,340,340,340,340,340,340,346,339,339,339,339,339,339,339,339,339,339,339,339,339,339,339,339,339,339,339
339,339,339,339,339,339,339,339,339,339,339,339,339,339,339,339,339,339,339,345,340,340,340,340,340,340,340,340,340,340,340,340,340,340,340,340,340,340,340,340,340,340,340,340,340,340,340,340,340,340,340,340,340,346,339,339,339,339,339,339,339,339,339,339,339,339,339,339,339,339,339,339,339
339,339,339,339,339,339,339,339,339,339,339,339,339,339,339,339,339,339,339,344,348,348,348,348,348,348,348,348,348,348,348,348,348,348,348,348,340,340,340,340,340,348,348,348,348,348,348,348,348,348,348,348,348,343,339,339,339,339,339,339,339,339,339,339,339,339,339,339,339,339,339,339,339
339,339,339,339,339,339,339,339,339,339,339,339,339,339,339,339,339,339,339,339,339,339,339,339,339,339,339,339,339,339,339,339,339,339,339,339,340,340,340,340,340,339,339,339,339,339,339,339,339,339,339,339,339,339,339,339,339,339,339,339,339,339,339,339,339,339,339,339,339,339,339,339,339
339,339,339,339,339,339,339,339,339,339,339,339,339,339,339,339,339,339,339,339,339,339,339,339,339,339,339,339,339,339,339,339,339,339,339,339,340,340,340,340,340,339,339,339,339,339,339,339,339,339,339,339,339,339,339,339,339,339,339,339,339,339,339,339,339,339,339,339,339,339,339,339,339
339,339,339,339,339,339,339,339,339,339,339,339,339,339,339,339,339,339,339,339,339,339,339,339,339,339,339,339,339,339,339,339,339,339,339,339,340,340,340,340,340,339,339,339,339,339,339,339,339,339,339,339,339,339,339,339,339,339,339,339,339,339,339,339,339,339,339,339,339,339,339,339,339
339,339,339,339,339,339,339,339,339,339,339,339,339,339,339,339,339,339,339,339,339,339,339,339,339,339,339,339,339,339,339,339,339,339,339,339,340,340,340,340,340,339,339,339,339,339,339,339,339,339,339,339,339,339,339,339,339,339,339,339,339,339,339,339,339,339,339,339,339,339,339,339,339
339,339,339,339,339,339,339,339,339,339,339,339,339,339,339,339,339,339,339,339,339,339,339,339,339,339,339,339,339,339,339,339,339,339,339,339,340,340,340,340,340,339,339,339,339,339,339,339,339,339,339,339,339,339,339,339,339,339,339,339,339,339,339,339,339,339,339,339,339,339,339,339,339
339,339,339,339,339,339,339,339,339,339,339,339,339,339,339,339,339,339,339,339,339,339,339,339,339,339,339,339,339,339,339,339,339,339,339,339,340,340,340,340,340,339,339,339,339,339,339,339,339,339,339,339,339,339,339,339,339,339,339,339,339,339,339,339,339,339,339,339,339,339,339,339,339
339,339,339,339,339,339,339,339,339,339,339,339,339,339,339,339,339,339,339,339,339,339,339,339,339,339,339,339,339,339,339,339,339,339,339,339,340,340,340,340,340,339,339,339,339,339,339,339,339,339,339,339,339,339,339,339,339,339,339,339,339,339,339,339,339,339,339,339,339,339,339,339,339
339,339,339,339,339,339,339,339,339,339,339,339,339,339,339,339,339,339,339,339,339,339,339,339,339,339,339,339,339,339,339,339,339,339,339,339,340,340,340,340,340,339,339,339,339,339,339,339,339,339,339,339,339,339,339,339,339,339,339,339,339,339,339,339,339,339,339,339,339,339,339,339,339
339,339,339,339,339,339,339,339,339,339,336,336,336,336,336,336,336,336,336,339,339,339,339,339,339,339,339,339,339,339,339,339,339,339,339,339,340,340,340,340,340,339,339,339,339,339,339,339,339,339,339,339,339,339,339,339,339,339,339,339,339,339,339,339,339,339,339,339,339,339,339,339,339
